HomeTeam	WeatherCode
BOS	KBOS
SF	KSFO
ATL	KPDK
CWS	KMDW
MIL	KMKE
KC	KNKA
NYM	KNYC
PIT	KAGC
LAA	KFUL
WSH	KDCA
ARI	KPHX
OAK	KOAK
HOU	KHOU
CIN	KLUK
TEX	KGKY
TB	KTPF
DET	KDET
FLA	KMIA
COL	KAPA
BAL	KBWI
SD	KSAN
MIN	KMIC
TOR	CYTZ
STL	KSTL
CHC	KMDW
SEA	KBFI
CLE	KBKL
PHI	KPNE
NYY	KNYC
LAD	KCQT
MIA	KMIA
